#                            #
##############################
#             ##             #
#             ##             #
#             ##             #
#                            #
#                            #
#             ##             #
#             ##             #
#        #####################
#                            #
#                            #
#                            #
#                            #
#                            #
#########                    D
#       #                    #
#       #                    #
#       #                    #
#       #                    #
#       #                    #
#       #                    #
#       #############        #
#                            #
#                            #
#                            #
#             ##             #
#             ##             #
#   P         ##             #
#             ##             #
##############################