#                            #
##############################
#                            #
#                            #
#                            #
#                            D
#                            #
#                            #
#                            #
#        ######  #####       #
#        #           #       #
#        #           #       #
#        #           #       #
#        #           #       #
#        ######  #####       #
#                            #
#                            #
#                            #
#                            #
#                            #
#                            #
#                            #
#        ######  #####       #
#        #           #       #
#        #           #       #
#        #     P     #       #
#        #           #       #
#        ######  #####       #
#                            #
#                            #
##############################