#                            #
##############################
#                            #
#                            #
#              P             #
#                            #
#                            #
#     ########################
#                            #
#                            #
#                            #
#                            #
#                            #
########################     #
#                            #
#                            #
#                            #
#                            #
#                            #
#     ########################
#                            #
#                            #
#                            #
#                            #
#                            #
#                            #
#                            D
#                            #
#                            #
#                            #
##############################