#                            #
##############################
#             ##             #
#             ##             #
#             ##             #
#             ##             #
#             ##             #
#             ##             #
#             ##             #
#        ############        #
#                            #
#                            #
#                            #
#                            #
#                            #
#              P             D
#                            #
#                            #
#                            #
#                            #
#                            #
#                            #
#        ############        #
#             ##             #
#             ##             #
#             ##             #
#             ##             #
#             ##             #
#             ##             #
#             ##             #
##############################