#                            #
##############################
#                            #
#                            #
#             P              #
#                            D
#                            #
#                            #
##########          ##########
#                            #
#                            #
#                            #
#                            #
#                            #
#                            #
#                            #
#                            #
#                            #
#                            #
#                            #
#                            #
#                            #
#                            #
#                            #
##########          ##########
#                            #
#                            #
#                            #
#                            #
#                            #
##############################